щ=sht
ц=ts
ч=ch
ш=sh
ж=zh
ю=yu
я=ya
а=a
б=b
в=v
г=g
д=d
е=e
з=z
и=i
й=y
к=k
л=l
м=m
н=n
о=o
п=p
р=r
с=s
т=t
у=u
ф=f
х=h
ъ=a
ь=y