đ=dj
lj=lj
nj=nj
dž=dz
a=a
b=b
v=v
g=g
d=d
e=e
ž=z
z=z
i=i
j=j
k=k
l=l
m=m
n=n
o=o
p=p
r=r
s=s
t=t
ć=c
u=u
f=f
h=h
c=c
č=c
š=s