
きゃ=kya
きゅ=kyu
きょ=kyo

しゃ=sha
しゅ=shu
しょ=sho

ちゃ=cha
ちゅ=chu
ちょ=cho

にゃ=nya
にゅ=nyu
にょ=nyo

ひゃ=hya
ひゅ=hyu
ひょ=hyo

みゃ=mya
みゅ=myu
みょ=myo

りゃ=rya
りゅ=ryu
りょ=ryo

うぃ=wi
うぇ=we
うぉ=who

ふぁ=fa
ふぃ=fi
ふぇ=fe

ふぉ=fo
てぃ=thi

ぎゃ=gya
ぎゅ=gyu
ぎょ=gyo

じゃ=ja
じゅ=ju
じょ=jo

びゃ=bya
びゅ=byu
びょ=byo

ぴゃ=pya
ぴゅ=pyu
ぴょ=pyo

あ=a
い=i
う=u
え=e
お=o

か=ka
き=ki
く=ku
け=ke
こ=ko

さ=sa
し=shi
す=su
せ=se
そ=so

た=ta
ち=chi
つ=tsu
て=te
と=to

な=na
に=ni
ぬ=nu
ね=ne
の=no

は=ha
ひ=hi
ふ=fu
へ=he
ほ=ho

ま=ma
み=mi
む=mu
め=me
も=mo

や=ya
ゆ=yu
よ=yo

ら=ra
り=ri
る=ru
れ=re
ろ=ro

わ=wa
を=o
ん=n

が=ga
ぎ=gi
ぐ=gu
げ=ge
ご=go

ざ=za
じ=ji
ず=zu
ぜ=ze
ぞ=zo

だ=da
ぢ=ji
づ=zu
で=de
ど=do

ば=ba
び=bi
ぶ=bu
べ=be
ぼ=bo

ぱ=pa
ぴ=pi
ぷ=pu
ぺ=pe
ぽ=po
