ж=zh
ч=ch
ш=sh
щ=sh
ю=yu
я=ya
а=a
б=b
в=v
г=g
д=d
е=e
ё=e
з=z
и=i
й=y
к=k
л=l
м=m
н=n
о=o
п=p
р=r
с=s
т=t
у=u
ф=f
х=h
ц=c
ъ='
ы=i
ь='
э=e