tst=тст
aya=ая
iya=ия
iyo=иё
iyu=ию
oya=оя
uya=уя
yoy=ёй
yuy=юй
yay=яй
ay=ай
aj=ай
ej=ей
ey=ей
ij=ий
iy=ий
oj=ой
oy=ой
uj=уй
uy=уй
yy=ый
csh=щ
ja=я
jo=ё
ju=ю
ya=я
yo=ё
yu=ю
sh=ш
ch=ч
ts=ц
zh=ж
kh=х
a=а
b=б
c=ц
d=д
e=е
f=ф
g=г
h=х
i=и
k=к
l=л
m=м
n=н
o=о
p=п
r=р
s=с
t=т
u=у
v=в
x=кс
y=ы
z=з
`=ъ
'=ь