юй=yuy
яй=yay
ёй=yoy
ий=iy
ой=oy
уй=uy
ай=ay
ей=ey
ый=yy
щ=csh
ш=sh
э=ey
ж=zh
ц=ts
ч=ch
ё=yo
ю=yu
я=ya
а=a
б=b
в=v
г=g
д=d
е=e
з=z
и=i
к=k
л=l
м=m
н=n
о=o
п=p
р=r
с=s
т=t
у=u
ф=f
х=h
ъ=`
ы=y
ь='
э=e