ђ=dj
љ=lj
њ=nj
џ=dz
a=a
б=b
в=v
г=g
д=d
е=e
ж=z
з=z
и=i
ј=j
к=k
л=l
м=m
н=n
о=o
п=p
р=r
с=s
т=t
ћ=c
у=u
ф=f
х=h
ц=c
ч=c
ш=s