ж=zh
ч=ch
ш=sh
щ=sh
ю=yu
я=ya
а=a
б=b
в=v
г=g
д=d
е=e
з=z
и=y
і=i
ї=i
й=y
к=k
л=l
м=m
н=n
о=o
п=p
р=r
с=s
т=t
у=u
ф=f
х=h
ц=c
ь='
є=je